-,B,-,-,-,B,-,-,-,B,-,-,-,B, 
B,B,B,-,B,B,B,-,B,B,B,-,B,B,B, 
B,B,B,B,B,B,B,B,B,B,B,B,B,B,B,B, 
B,B,B,-,B,B,B,-,B,B,B,-,B,B,B,-, 
-,B,-,-,-,B,-,-,-,B,-,-,-,B,-,-, 
-,-,-,-,H,H,H,-,-,-,-,-,-,-,-,-, 
-,G,-,-,-,G,-,-,-,G,-,-,-,G,-,-, 
B,B,B,-,B,B,B,-,B,B,B,-,B,B,B,-, 
B,B,B,-,B,B,-,-,-,B,B,-,B,B,B,-,
-,-,H,H,-,-,-,-,-,-,-,-,H,H,-,-